통 : 통합보건
합 : 통합보건교
교 : 합보건교육은
육 : 보건교육은 이
학 : 이 대학만의
특 : 만의 특화된
화 : 의 특화된 프
램 : 프로그램이다.
따 : 이에 따라 전
후 : 달된 후원금은
층 : 저소득층과 사
회 : 과 사회복지시
복 : 사회복지시설
억 : 에 2억원 상
상 : 억원 상당을,
구 : , 중구 푸드
푸 : 중구 푸드뱅크
드 : 구 푸드뱅크
뱅 : 푸드뱅크 설
크 : 푸드뱅크 설립
립 : 크 설립 지원
긴 : 소득 긴급지원
급 : 득 긴급지원과
해 : 이 전해진다.
콤 : 오리콤은 이
모 : 이에 모든 조
든 : 에 모든 조직
조 : 모든 조직과
직 : 든 조직과 프
스 : 프로세스를 바
바 : 스를 바꾸기로
꾸 : 를 바꾸기로
했 : 기로 했다.
청 : 방사청은 이
번 : 은 이번 원가
관 : 원가관리 안
안 : 관리 안내서를
망 : 를 희망하는
하 : 희망하는 기
업 : 는 기업에 무
무 : 업에 무료로
료 : 에 무료로 배
배 : 료로 배포할
예 : 포할 예정이다
정 : 할 예정이다.
나 : 그러나 이
물 : 이 건물은 겉
겉 : 물은 겉에서
것 : 보는 것과는
꽤 : 지가 꽤 오래
래 : 꽤 오래되었는
되 : 오래되었는지
약 : 방이 약간 낡
간 : 이 약간 낡았
낡 : 약간 낡았다는
주 : 낌을 주었다.
런 : 그런데 황
데 : 그런데 황희
황 : 런데 황희찬이
찬 : 황희찬이 다
올 : 부로 올라갈
갈 : 올라갈 수도
도 : 갈 수도 있다
있 : 수도 있다.
응 : 응답자
답 : 응답자 중
자 : 응답자 중
많 : 가장 많은 의
견 : 은 의견이었다
씨 : P씨는 2
일 : 23일 오전
쯤 : 30분쯤 벤츠
벤 : 분쯤 벤츠 승
츠 : 쯤 벤츠 승용
승 : 벤츠 승용차를
용 : 츠 승용차를
몰 : 차를 몰고 서
울 : 고 서울 마장
마 : 서울 마장동
동 : 마장동 내부
순 : 내부순환로를
환 : 내부순환로를
커 : 리다 커브길에
브 : 다 커브길에서
좌 : 에서 좌우 방
우 : 서 좌우 방호
호 : 우 방호벽을
벽 : 방호벽을 차
례 : 을 차례로 들
들 : 례로 들이받았
니 : 니트는
트 : 니트는 당
